11111111111111111111
10000000000000000001
10011000000111000001
10001000000010101001
10000000000001111101
10001010101010101001
10001111111111011101
10001010001010001001
10111111011110000001
10101010101000001001
10100000101111111101
10100010100010101001
10011110111110001101
10101010101000001001
10111111011010000001
10101010001010001001
10000011011100011101
10000010001000001001
10000000000000000001
11111111111111111111