11111111211111111111
10000000000000000001
10000111000000011101
10001010001010001001
10011111001111011001
10001010001000000001
10111111011100000001
10101000001000000001
10001111001100000001
10101010001000101001
10111111000000111101
10101010001010101001
20110000011110011101
10101010001010101001
10111111000001111101
10000010100010101001
10111111111011111101
10100010101010001001
10000000000000000001
11111111121111111111