12111111111111111111
10000000000000000001
10011111111111001101
10001000001010001001
10111000000000001101
10100000000000000001
10000000110000011001
10000000100000101001
10000000100000100001
10000010101000100001
10001110111101100001
10001000001000000001
10111000000000000001
10101000000010000001
10000000000110000001
10100010101000000001
10100011111110001101
10100010001010001001
10000000000000000001
11111111111111111111